


**********S*****************************************************
********** *********************** *****************************
********** *****************************************************
**********                         *****************************
***************** **********************************************
***************** **********************************************
***************** **********************************************
***************** **********************************************
*******                                            *************
******* *************** ***************** **********************
******* *************** ***************** **********************
******* *************** ***************** **********************
******* *************** ***************** **********************
***     ************                      **********************
*** ************************************************************
*** ************************************************************
*** ************************************************************
***                           **********************************
**************************** ***********************************
**************************** ***********************************
**************************** ************************ **********
**************************** ************************ **********
***********                  ************************ **********
**************************** ************************ **********
****************************                            ********
************************************ ***************************
************************************ ***************************
************************************ ***************************
************************************                           i
****************************************************************

